
a keen insight into - глубокое понимание
a tough judgment call - непростое решение
all but one - все кроме одного
alterations - изменения, переделки
an apples-to-apples comparison - (отделим мухи от котлет)
ancestry - происхождение, родословная
attainment - достижение
bane - проклятие, бич
causality - причинность, причинная связь
caveat - огоаворка, предупрежедние
census - перепись населения
concern - проблема. забота, касаться, беспокоить
decennial - десятилетний
dire error - грубая ошибка
discern - различать, распознать, определить, понять
glean = получить, почерпнуть, собрать, извлечь, добыть, подобрать
hamper - препятствовать, мешать, затруднять. тормозить, сдерживать
inadvertently - непреднамеренно. случайно, неосторожно
indispensable - незаменимый, необходимый
irrevocable - безотзывный, безвозвратный, необратимый, неизменный
least squares regression line - линия регрессии по методу наименьших квадратов
mint - мята, монетный двор, чеканить
mishmash - мешанина, смесь, путаница
pristine - нетронутый, первозданный, чистый, древний, девственной
rate - ставка, темп, скорость, показатель
rigorous - строгий, тщательный. суровый, жесткий, точный
rolling averages - скользящие средние значения
slaughter - убой, бойня, забивать, зарезать, заклание
slope upward - склоняться вверх
spike - всплеск, скачок
tie - связать, привязать, галстук, связь, ... ничья ... (the way they handle the next rank value after a tie:)
to assess - оценивать
to botch - испортить, запороть, накосячить, халтура
to commute more than 60 minutes to work - добираться на работу дольше часа
to defy - противоречить здравому смыслу, игнорировать, пренебрегать
to obviate - избежать, устранить, отменить
to persist - сохраняться, продолжать, длиться, настаивать
to skim the surface - скользить по поверхности, пробежаться по верхам
to toss - бросить, бросать, выбросить, жеребъевка
variance - дисперсия
your data is gone for good - данные исчезли (пропали) навсегда ...

